NO ./shrek.xpm
SO ./zied.xpm
WE ./portal_wall_so.xpm
EA ./enemy_1.xpm

F 220,255,0

C 0,0,255

11111111  1111111111111111
1000000000110000000000001
1011000001110000000000001
1001000000000000000000001
111111111011000001110000000000001
100000000011000001110111111111111
11110111111111011100000010001
11110111111111011101010010001
11000000110101011100000010001
10000000000110000010001
1000000N000000110101000001
11000000101010111110111100111
11110111 1110101 101111010001
11111111 1111111 11111111111